"Altersgruppe";"männlich";"weiblich";"divers";"unbekannt";"Todesfälle insgesamt"
"0-9";0;0;0;0;0
"'10-19";2;0;0;0;2
"20-29";3;2;0;0;5
"30-39";3;2;0;0;5
"40-49";14;5;0;0;19
"50-59";72;29;0;0;101
"60-69";196;79;0;1;276
"70-79";464;262;0;0;726
"80-89";617;616;0;0;1233
"90-99";141;295;0;0;436
"100+";0;8;0;0;8
"Unbekannt";0;0;0;0;0
"Gesamt";1512;1298;0;1;2811
