"Altersgruppe";"männlich";"weiblich";"divers";"unbekannt";"Todesfälle insgesamt"
"0-9";0;0;0;0;0
"'10-19";1;0;0;0;1
"20-29";3;2;0;0;5
"30-39";3;2;0;0;5
"40-49";12;4;0;0;16
"50-59";68;29;0;0;97
"60-69";191;76;0;0;267
"70-79";441;246;0;0;687
"80-89";573;592;0;0;1165
"90-99";132;275;0;0;407
"100+";0;7;0;0;7
"Unbekannt";0;0;0;0;0
"Gesamt";1424;1233;0;0;2657
