"Altersgruppe";"männlich";"weiblich";"divers";"unbekannt";"Todesfälle insgesamt"
"0-9";0;0;0;0;0
"'10-19";1;0;0;0;1
"20-29";3;2;0;0;5
"30-39";1;2;0;0;3
"40-49";9;4;0;0;13
"50-59";54;24;0;0;78
"60-69";171;63;0;0;234
"70-79";375;213;0;1;589
"80-89";510;526;0;0;1036
"90-99";117;222;0;0;339
"100+";0;8;0;0;8
"Unbekannt";0;0;0;0;0
"Gesamt";1241;1064;0;1;2306
