"Altersgruppe";"männlich";"weiblich";"divers";"unbekannt";"Todesfälle insgesamt"
"0-9";0;2;0;0;2
"'10-19";1;0;0;0;1
"20-29";7;4;0;0;11
"30-39";10;6;0;0;16
"40-49";43;18;0;0;61
"50-59";291;104;0;0;395
"60-69";702;315;0;5;1022
"70-79";1825;1091;1;14;2931
"80-89";2811;3148;2;41;6002
"90-99";777;1689;1;26;2493
"100+";6;39;0;0;45
"Unbekannt";0;1;0;0;1
"Gesamt";6473;6417;4;86;12980
