"Altersgruppe";"männlich";"weiblich";"divers";"unbekannt";"Todesfälle insgesamt"
"0-9";0;2;0;0;2
"'10-19";1;1;0;0;2
"20-29";10;4;0;0;14
"30-39";20;10;0;0;30
"40-49";67;31;0;0;98
"50-59";396;153;0;1;550
"60-69";905;414;0;9;1328
"70-79";2182;1318;1;15;3516
"80-89";3170;3492;2;43;6707
"90-99";857;1831;1;29;2718
"100+";6;43;0;0;49
"Unbekannt";0;1;0;0;1
"Gesamt";7614;7300;4;97;15015
